1211111111111
1001C0C0000C1
1000011111111
100011E00P001
1111111111111